##############################
#        #      #            #
#        #  ##  #            #
#                    ###     #
#        ###  ###            #
#        #      #            #
#        ###  ###            #
#                    ###     #
#        #  ##  #            #
#        #      #            #
##############################